NO ./textures/BRICK_3D.xpm
WE ./textures/FLOOR_1B.xpm
SO ./textures/STUCCO_1D.xpm
EA ./textures/TECH_5A.xpm

F 220,100,0
C 225,30,0


        1111111111111111111111111
        1000000000110000000100001
        1011000001110000000D00001
        100100000000000N000100001
111111111011001001110000000D00001
1D000D00001100D001110111111111111
11110111101111111100000010001
11110111111111101101010010001
1101D101010101011100000010001
10010100000000001100000010001
10000000000000001101010010001
1100000111010101111101111000111
11110111 1110101 101111010001
11111111 1111111 111111111111

